{
  "levels": [
    {
      "name": "ez",
      "width": 5,
      "height": 6,
      "tiles": [
      1,1,1,1,1,
      1,0,201,0,1,
      1,0,0,0,1,
      1,0,0,0,1,
      1,0,100,0,1,
      1,1,1,1,1
      ]
    },
    {
      "name": "slightly less easy",
      "width": 5,
      "height": 6,
      "tiles": [
      1,1,1,1,1,
      1,202,0,0,201,
      1,0,1,1,1,
      1,0,0,101,1,
      1,0,100,0,1,
      1,1,1,1,1
      ]
    },
    {
      "name": "3 colors",
      "width": 7,
      "height": 9,
      "tiles":[
      1  ,1  ,1  ,1  ,1  ,1  ,1  ,
      1  ,1  ,1  ,1  ,1  ,1  ,1  ,
      1  ,1  ,100,1  ,1  ,1  ,1  ,
      1  ,1  ,0  ,101,102,1  ,1  ,
      1  ,1  ,0  ,1  ,0  ,1  ,1  ,
      1  ,1  ,0  ,1  ,1  ,1  ,1  ,
      1  ,1  ,0  ,201,0  ,0  ,1  ,
      1  ,1  ,0  ,0  ,202,203,1  ,
      1  ,1  ,1  ,1  ,1  ,1  ,1  
      ]
    },
    {
      "name": "hop",
      "width": 3,
      "height": 10,
      "tiles": [
      1  ,1  ,1  ,
      1  ,101,1  ,
      1  ,201,1  ,
      1  ,0  ,1  ,
      1  ,0  ,1  ,
      1  ,0  ,1  ,
      1  ,0  ,1  ,
      1  ,202,1  ,
      1  ,100,1  ,
      1  ,1  ,1  
      ]
    },
    {
      "name": "corridor",
      "width": 5,
      "height": 12,
      "tiles":[
      1  ,1  ,1  ,1  ,1  ,
      1  ,103,202,1  ,1  ,
      1  ,100,0  ,102,1  ,
      1  ,0  ,0  ,1  ,1  ,
      1  ,0  ,0  ,1  ,1  ,
      1  ,0  ,0  ,1  ,1  ,
      1  ,0  ,0  ,1  ,1  ,
      1  ,0  ,0  ,1  ,1  ,
      1  ,0  ,0  ,201,1  ,
      1  ,0  ,0  ,101,1  ,
      1  ,1  ,203,204,1  ,
      1  ,1  ,1  ,1  ,1  
      ]
    },
    {
      "name": "intersection",
      "width": 8,
      "height": 8,
      "tiles":[
      1  ,1  ,1  ,1  ,1  ,1  ,1  ,1  ,
      1  ,1  ,202,1  ,0  ,1  ,1  ,1  ,
      1  ,1  ,0  ,1  ,0  ,1  ,1  ,1  ,
      201,0  ,0  ,0  ,0  ,0  ,100,1  ,
      1  ,1  ,1  ,1  ,0  ,1  ,203,1  ,
      1  ,1  ,1  ,1  ,102,1  ,101,1  ,
      1  ,1  ,1  ,1  ,1  ,1  ,1  ,1  
      ]
    },
    {
      "name": "qwerty",
      "width": 10,
      "height": 8,
      "tiles":[
      1  ,1  ,1  ,1  ,1  ,1  ,1  ,1  ,1  ,1  ,
      1  ,1  ,1  ,1  ,1  ,1  ,1  ,204,1  ,1  ,
      1  ,202,100,0  ,0  ,0  ,0  ,0  ,201,1  ,
      1  ,1  ,1  ,1  ,1  ,101,1  ,0  ,1  ,1  ,
      1  ,1  ,203,0  ,0  ,0  ,0  ,0  ,102,1  ,
      1  ,1  ,1  ,1  ,1  ,0  ,1  ,103,1  ,1  ,
      1  ,1  ,1  ,1  ,1  ,1  ,1  ,0  ,1  ,1  ,
      1  ,1  ,1  ,1  ,1  ,1  ,1  ,1  ,1  ,1  
      ]
    },
    {
      "name": "fast forward",
      "width": 9,
      "height": 9,
      "tiles":[
      1  ,1  ,1  ,1  ,1  ,1  ,1  ,1  ,1  ,
      1  ,100,0  ,0  ,203,0  ,0  ,101,1  ,
      1  ,0  ,1  ,1  ,0  ,1  ,1  ,0  ,1  ,
      1  ,103,1  ,1  ,0  ,1  ,1  ,0  ,1  ,
      1  ,0  ,1  ,1  ,301,0  ,0  ,0  ,1  ,
      1  ,0  ,1  ,1  ,1  ,1  ,1  ,0  ,1  ,
      1  ,0  ,1  ,1  ,1  ,1  ,1  ,0  ,1  ,
      1  ,202,0  ,102,0  ,204,0  ,201,1  ,
      1  ,1  ,1  ,1  ,1  ,1  ,1  ,1  ,1  
      ]

    },
    {
      "name": "traffic",
      "width": 7,
      "height": 8,
      "tiles":[
      1  ,1  ,1  ,1  ,1  ,1  ,1  ,
      1  ,1  ,1  ,202,1  ,204,1  ,
      1  ,203,0  ,100,1  ,0  ,1  ,
      1  ,0  ,1  ,0  ,1  ,201,1  ,
      1  ,301,0  ,103,1  ,101,1  ,
      1  ,1  ,1  ,0  ,1  ,0  ,1  ,
      1  ,102,0  ,0  ,0  ,0  ,1  ,
      1  ,1  ,1  ,1  ,1  ,1  ,1  
      ]
    },
    {
      "name": "some symmetry",
      "width": 9,
      "height": 9,
      "tiles":[
      1  ,1  ,1  ,1  ,1  ,1  ,1  ,1  ,1  ,
      1  ,0  ,0  ,204,0  ,201,0  ,101,1  ,
      1  ,0  ,1  ,0  ,1  ,0  ,1  ,0  ,1  ,
      1  ,102,0  ,0  ,0  ,0  ,0  ,0  ,1  ,
      1  ,0  ,1  ,0  ,1  ,0  ,1  ,0  ,1  ,
      1  ,0  ,0  ,0  ,0  ,0  ,0  ,103,1  ,
      1  ,0  ,1  ,0  ,1  ,0  ,1  ,0  ,1  ,
      1  ,100,0  ,202,0  ,203,0  ,0  ,1  ,
      1  ,1  ,1  ,1  ,1  ,1  ,1  ,1  ,1  
      ]
    },
    {
      "name": "step outside",
      "width": 9,
      "height": 8,
      "tiles":[
      0  ,0  ,0  ,0  ,0  ,203,0  ,0  ,0  ,
      1  ,0  ,1  ,1  ,1  ,1  ,1  ,1  ,0  ,
      1  ,0  ,0  ,0  ,205,0  ,101,201,0  ,
      1  ,103,1  ,1  ,1  ,1  ,1  ,1  ,0  ,
      1  ,0  ,1  ,1  ,1  ,202,301,0  ,104,
      1  ,0  ,0  ,0  ,1  ,1  ,1  ,1  ,0  ,
      1  ,1  ,0  ,0  ,0  ,204,100,1  ,102,
      1  ,1  ,1  ,1  ,1  ,1  ,1  ,1  ,0  
      ]
    },
    {
      "name": "don't wander off",
      "width": 9,
      "height": 8,
      "tiles":[
      0  ,0  ,0  ,0  ,0  ,0  ,0  ,0  ,0  ,
      0  ,102,1  ,301,1  ,101,0  ,0  ,1  ,
      0  ,1  ,1  ,203,1  ,0  ,0  ,0  ,1  ,
      0  ,0  ,0  ,301,1  ,201,0  ,0  ,1  ,
      0  ,1  ,1  ,1  ,1  ,1  ,0  ,0  ,1  ,
      0  ,0  ,100,202,1  ,1  ,0  ,0  ,1  ,
      0  ,1  ,1  ,1  ,1  ,1  ,1  ,0  ,1  ,
      0  ,0  ,0  ,0  ,0  ,0  ,0  ,0  ,0  

      ]
    },
    {
      "name": "time rations",
      "width": 6,
      "height": 6,
      "tiles":[
      1  ,1  ,0  ,301,301,0  ,
      1  ,201,203,1  ,101,204,
      1  ,0  ,301,301,0  ,0  ,
      0  ,301,301,301,0  ,0  ,
      1  ,301,202,1  ,100,0  ,
      0  ,0  ,103,1  ,1  ,102
      ]
    },
    {
      "name": "minefield",
      "width": 8,
      "height": 8,
      "tiles":[
      301,301,301,301,301,301,301,301,
      301,301,1  ,301,301,301,301,301,
      301,1  ,202,301,301,301,201,301,
      301,301,203,301,1  ,1  ,102,301,
      301,1  ,301,100,301,301,301,301,
      301,1  ,301,1  ,301,0  ,1  ,301,
      301,301,0  ,301,301,101,1  ,301,
      301,301,301,301,301,301,301,301

      ]
    },
    {
      "name": "back in a box",
      "width": 8,
      "height": 8,
      "tiles":[
      1  ,1  ,1  ,1  ,1  ,1  ,1  ,1  ,
      1  ,0  ,202,0  ,103,0  ,100,1  ,
      1  ,0  ,0  ,1  ,1  ,0  ,0  ,1  ,
      1  ,0  ,0  ,1  ,0  ,0  ,102,1  ,
      1  ,1  ,201,0  ,0  ,301,0  ,1  ,
      1  ,0  ,301,0  ,0  ,0  ,301,1  ,
      1  ,203,1  ,301,204,101,0  ,1  ,
      1  ,1  ,1  ,1  ,1  ,1  ,1  ,1  

      ]
    },
    {
      "name": "crowded",
      "width": 5,
      "height": 6,
      "tiles":[
      1  ,0  ,1  ,104,301,
      1  ,103,0  ,201,0  ,
      301,101,100,202,0  ,
      1  ,203,301,102,1  ,
      0  ,0  ,1  ,204,0  ,
      1  ,205,301,0  ,1
      ]
    },
    {
      "name": "tunnels",
      "width": 11,
      "height": 9,
      "tiles":[
      1  ,1  ,1  ,1  ,1  ,1  ,1  ,1  ,1  ,1  ,1  ,
      1  ,204,100,1  ,0  ,201,1  ,1  ,1  ,1  ,1  ,
      1  ,102,0  ,1  ,0  ,103,1  ,0  ,0  ,104,1  ,
      1  ,1  ,0  ,1  ,0  ,0  ,0  ,202,0  ,0  ,1  ,
      1  ,1  ,0  ,0  ,0  ,0  ,1  ,1  ,1  ,1  ,1  ,
      1  ,1  ,301,1  ,0  ,1  ,1  ,0  ,101,1  ,1  ,
      1  ,1  ,0  ,1  ,0  ,0  ,0  ,0  ,0  ,1  ,1  ,
      1  ,1  ,205,0  ,0  ,1  ,1  ,0  ,203,1  ,1  ,
      1  ,1  ,1  ,1  ,1  ,1  ,1  ,1  ,1  ,1  ,1  
      ]
    },
    {
      "name": "speeeeed",
      "width": 9,
      "height": 10,
      "tiles":[
      1  ,1  ,1  ,1  ,1  ,1  ,1  ,1  ,1  ,
      301,301,101,301,301,301,301,100,1  ,
      301,301,301,0  ,0  ,0  ,0  ,204,1  ,
      301,203,301,301,0  ,301,301,301,1  ,
      301,0  ,301,301,0  ,301,301,301,1  ,
      301,0  ,0  ,301,0  ,0  ,0  ,202,1  ,
      301,301,0  ,301,301,301,0  ,301,1  ,
      301,301,0  ,103,0  ,0  ,0  ,301,301,
      301,201,301,301,301,301,301,102,301,
      301,301,301,301,301,301,301,301,301
      ]
    },
    {
      "name": "i ran out of names",
      "width": 9,
      "height": 9,
      "tiles":[
      1  ,1  ,1  ,1  ,202,1  ,1  ,1  ,1  ,
      1  ,1  ,1  ,1  ,103,1  ,1  ,1  ,1  ,
      1  ,1  ,1  ,1  ,0  ,1  ,1  ,1  ,1  ,
      1  ,1  ,1  ,0  ,0  ,0  ,1  ,1  ,1  ,
      201,102,0  ,0  ,301,0  ,0  ,100,1  ,
      1  ,1  ,1  ,0  ,0  ,0  ,1  ,301,1  ,
      1  ,1  ,1  ,1  ,204,1  ,1  ,301,1  ,
      1  ,1  ,1  ,1  ,101,301,301,203,1  ,
      1  ,1  ,1  ,1  ,1  ,1  ,1  ,1  ,1  
      ]
    },
    {
      "name": "this might take a while",
      "width": 100,
      "height": 5,
      "tiles":[
      201,0  ,0  ,0  ,0  ,0  ,0  ,0  ,0  ,0  ,0  ,0  ,0  ,0  ,0  ,0  ,0  ,0  ,0  ,0  ,0  ,0  ,0  ,0  ,0  ,0  ,0  ,0  ,0  ,0  ,0  ,0  ,0  ,0  ,0  ,0  ,0  ,0  ,0  ,0  ,0  ,0  ,0  ,0  ,0  ,0  ,0  ,0  ,0  ,0  ,0  ,0  ,0  ,0  ,0  ,0  ,0  ,0  ,0  ,0  ,0  ,0  ,0  ,0  ,0  ,0  ,0  ,0  ,0  ,0  ,0  ,0  ,0  ,0  ,0  ,0  ,0  ,0  ,0  ,0  ,0  ,0  ,0  ,0  ,0  ,0  ,0  ,0  ,0  ,0  ,0  ,0  ,0  ,0  ,0  ,1  ,0  ,0  ,0  ,0  ,
      0  ,0  ,0  ,0  ,0  ,0  ,0  ,0  ,0  ,0  ,0  ,0  ,0  ,0  ,0  ,0  ,0  ,0  ,0  ,0  ,0  ,0  ,0  ,0  ,0  ,0  ,0  ,0  ,0  ,0  ,0  ,0  ,0  ,0  ,0  ,0  ,0  ,0  ,0  ,0  ,0  ,0  ,0  ,0  ,0  ,0  ,0  ,0  ,0  ,0  ,0  ,0  ,0  ,0  ,0  ,0  ,0  ,0  ,0  ,0  ,0  ,0  ,0  ,0  ,0  ,0  ,0  ,0  ,0  ,0  ,0  ,0  ,0  ,0  ,0  ,0  ,0  ,0  ,0  ,0  ,0  ,0  ,0  ,0  ,0  ,0  ,0  ,0  ,0  ,0  ,0  ,0  ,0  ,0  ,1  ,0  ,0  ,0  ,0  ,0  ,
      0  ,0  ,0  ,0  ,0  ,0  ,0  ,0  ,0  ,0  ,0  ,0  ,0  ,0  ,0  ,0  ,0  ,0  ,0  ,0  ,0  ,0  ,0  ,0  ,0  ,0  ,0  ,0  ,0  ,0  ,0  ,0  ,0  ,0  ,0  ,0  ,0  ,0  ,0  ,0  ,0  ,0  ,0  ,0  ,0  ,0  ,0  ,0  ,0  ,0  ,0  ,0  ,0  ,0  ,0  ,0  ,0  ,0  ,0  ,0  ,0  ,0  ,0  ,0  ,0  ,0  ,0  ,0  ,0  ,0  ,0  ,0  ,0  ,0  ,0  ,0  ,0  ,0  ,0  ,0  ,0  ,0  ,0  ,0  ,0  ,0  ,0  ,0  ,0  ,0  ,0  ,0  ,0  ,1  ,1  ,1  ,1  ,1  ,1  ,100,
      0  ,0  ,0  ,0  ,0  ,0  ,0  ,0  ,0  ,0  ,0  ,0  ,0  ,0  ,0  ,0  ,0  ,0  ,0  ,0  ,0  ,0  ,0  ,0  ,0  ,0  ,0  ,0  ,0  ,0  ,0  ,0  ,0  ,0  ,0  ,0  ,0  ,0  ,0  ,0  ,0  ,0  ,0  ,0  ,0  ,0  ,0  ,0  ,0  ,0  ,0  ,0  ,0  ,0  ,0  ,0  ,0  ,0  ,0  ,0  ,0  ,0  ,0  ,0  ,0  ,0  ,0  ,0  ,0  ,0  ,0  ,0  ,0  ,0  ,0  ,0  ,0  ,0  ,0  ,0  ,0  ,0  ,0  ,0  ,0  ,0  ,0  ,0  ,0  ,0  ,0  ,0  ,0  ,0  ,1  ,0  ,0  ,0  ,0  ,0  ,
      0  ,0  ,0  ,0  ,0  ,0  ,0  ,0  ,0  ,0  ,0  ,0  ,0  ,0  ,0  ,0  ,0  ,0  ,0  ,0  ,0  ,0  ,0  ,0  ,0  ,0  ,0  ,0  ,0  ,0  ,0  ,0  ,0  ,0  ,0  ,0  ,0  ,0  ,0  ,0  ,0  ,0  ,0  ,0  ,0  ,0  ,0  ,0  ,0  ,0  ,0  ,0  ,0  ,0  ,0  ,0  ,0  ,0  ,0  ,0  ,0  ,0  ,0  ,0  ,0  ,0  ,0  ,0  ,0  ,0  ,0  ,0  ,0  ,0  ,0  ,0  ,0  ,0  ,0  ,0  ,0  ,0  ,0  ,0  ,0  ,0  ,0  ,0  ,0  ,0  ,0  ,0  ,0  ,0  ,0  ,1  ,0  ,0  ,0  ,0

      ]
    },
    {
      "name": "uhhhh",
      "width": 5,
      "height": 3,
      "tiles":[
      1  ,1  ,1  ,1  ,0  ,
      1  ,100,0  ,1  ,201,
      1  ,1  ,1  ,1  ,0  
      ]
    },
    {
      "name": "nothing",
      "width": 1,
      "height": 1,
      "tiles":[
      0
      ]
    }
  ]
}